16 12
64 64
resources/sprites/GroundTiles.png
0 0 0 0 1 0 1 0 1 1 0 1 0 1 0 1
0 2 1 0 1 0 2 0 1 0 1 1 1 0 0 0
0 1 2 0 0 0 1 0 0 1 0 0 1 1 0 0
1 0 2 2 1 0 1 2 3 0 1 0 0 1 0 1
0 2 0 2 2 1 0 1 2 3 0 1 0 0 0 1
2 1 0 2 0 0 2 2 0 1 0 0 0 1 0 0
0 2 1 0 1 2 0 0 1 7 3 0 0 1 1 0
0 0 2 2 0 0 1 0 3 4 5 6 3 0 0 1
1 0 0 0 1 0 0 3 11 8 9 9 9 9 9 9
0 1 0 2 0 1 0 3 7 12 13 14 3 2 1 0
0 0 0 1 0 0 0 1 0 2 2 1 0 0 1 0
0 1 0 0 0 0 1 0 0 2 0 0 1 0 0 1
