12 12
64 64
resources/sprites/GroundTiles.png
1 0 1 0 1 1 0 1 0 1 0 1
1 3 2 0 1 0 1 1 1 0 0 0
0 3 3 0 3 1 0 0 1 1 0 0
1 3 4 5 6 0 1 0 0 1 0 1
2 1 8 1 10 3 0 1 0 0 0 1
3 7 8 2 10 15 1 2 0 1 0 0
1 9 9 9 10 15 1 2 0 1 1 0
0 9 12 13 14 4 5 6 3 0 0 1
9 9 0 3 0 0 0 0 0 0 0 0
0 1 0 2 1 1 0 0 3 2 1 0
0 0 0 1 0 2 2 1 0 0 1 0
0 0 1 0 0 2 0 0 1 0 0 1
