12 12
64 64
resources/sprites/GroundTiles.png
1 0 1 0 1 1 0 1 0 1 0 1
1 3 2 0 1 0 1 1 1 0 0 0
0 3 3 0 3 1 0 0 1 1 0 0
1 3 4 2 2 2 1 0 0 1 0 1
2 1 1 2 2 2 5 6 0 0 0 1
3 6 4 2 2 2 1 2 0 1 0 0
1 4 4 4 4 3 1 2 0 1 1 0
0 3 4 4 3 4 5 6 3 0 0 1
1 1 0 3 0 0 0 0 0 0 0 0
0 1 0 2 1 1 0 0 3 2 1 0
0 0 0 1 0 2 2 1 0 0 1 0
0 0 1 0 0 2 0 0 1 0 0 1
